concall_id,positive,negative,neutral,total,pos_pct,neg_pct
concall_1,21,14,38,73,28.8,19.2
concall_2,38,6,82,126,30.2,4.8
concall_3,35,15,62,112,31.2,13.4
concall_5,44,16,107,167,26.3,9.6
concall_6,33,14,85,132,25.0,10.6
concall_7,32,21,92,145,22.1,14.5
concall_8,41,9,65,115,35.7,7.8
concall_9,23,13,25,61,37.7,21.3
concall_10,40,14,85,139,28.8,10.1
concall_12,37,3,89,129,28.7,2.3
concall_14,21,3,76,100,21.0,3.0
concall_15,37,10,50,97,38.1,10.3
